  64 128 128 128 128 128 128 128 128 128 128 128 128 128 128 128
 128 255 255 255 255 255 255 254 251 255 255 255 255 255 255 255
 128 255 255 255 255 255 255 254 251 255 255 255 255 255 255 255
 128 255 255 255 127   0   0   0   0   0   0 138 255 255 255 255
 128 255 255 255  32   0   0  16   0   0   0   0 178 255 255 255
 128 255 255 255 149 234 234 255 251   0   0   0 138 255 255 255
 128 255 255 255 149 234 234 255 251   0   0   0 138 255 255 255
 128 255 255 255 255 255 255 255 255   0   0   0 138 255 255 255
 128 255 255 255 255 255 255 255 102   0   0   0 248 255 255 255
 128 255 255 255 255 255 255  89   0   0   0 210 255 255 255 255
 128 255 255 255 255 255 255  89   0   0   0 210 255 255 255 255
 128 255 255 255 248  32  32   0   0 228 228 255 255 255 255 255
 128 255 255 254   0   0   0   0   0  32  32   0   0 255 255 255
 128 255 255 254   0   0   0   0   0   0   0   0   0 255 255 255
 128 255 255 254   0   0   0   0   0   0   0   0   0 255 255 255
 128 255 255 255 255 255 255 255 255 255 255 255 255 255 255 255
  64 128 128 128 128 128 128 128 128 128 128 128 128 128 128 128
 128 255 255 255 255 255 255 254 251 255 255 255 255 255 255 255
 128 255 255 255 255 255 255 254 251 255 255 255 255 255 255 255
 128 255 255 255 127   0   0   0   0   0   0 138 255 255 255 255
 128 255 255 255  32   0   0  16   0   0   0   0 178 255 255 255
 128 255 255 255 149 234 234 255 251   0   0   0 138 255 255 255
 128 255 255 255 149 234 234 255 251   0   0   0 138 255 255 255
 128 255 255 255 255 255 255 255 255   0   0   0 138 255 255 255
 128 255 255 255 255 255 255 255 102   0   0   0 248 255 255 255
 128 255 255 255 255 255 255  89   0   0   0 210 255 255 255 255
 128 255 255 255 255 255 255  89   0   0   0 210 255 255 255 255
 128 255 255 255 248  32  32   0   0 228 228 255 255 255 255 255
 128 255 255 254   0   0   0   0   0  32  32   0   0 255 255 255
 128 255 255 254   0   0   0   0   0   0   0   0   0 255 255 255
 128 255 255 254   0   0   0   0   0   0   0   0   0 255 255 255
 128 255 255 255 255 255 255 255 255 255 255 255 255 255 255 255
  64 128 128 128 128 128 128 128 128 128 128 128 128 128 128 128
 128 255 255 255 255 255 255 254 251 255 255 255 255 255 255 255
 128 255 255 255 255 255 255 254 251 255 255 255 255 255 255 255
 128 255 255 255 127   0   0   0   0   0   0 138 255 255 255 255
 128 255 255 255  32   0   0  16   0   0   0   0 178 255 255 255
 128 255 255 255 149 234 234 255 251   0   0   0 138 255 255 255
 128 255 255 255 149 234 234 255 251   0   0   0 138 255 255 255
 128 255 255 255 255 255 255 255 255   0   0   0 138 255 255 255
 128 255 255 255 255 255 255 255 102   0   0   0 248 255 255 255
 128 255 255 255 255 255 255  89   0   0   0 210 255 255 255 255
 128 255 255 255 255 255 255  89   0   0   0 210 255 255 255 255
 128 255 255 255 248  32  32   0   0 228 228 255 255 255 255 255
 128 255 255 254   0   0   0   0   0  32  32   0   0 255 255 255
 128 255 255 254   0   0   0   0   0   0   0   0   0 255 255 255
 128 255 255 254   0   0   0   0   0   0   0   0   0 255 255 255
 128 255 255 255 255 255 255 255 255 255 255 255 255 255 255 255

 128 255 255 255 255 255 255 255 255 255 255 255 255 255 255 255
 128 255 255 255 255 255 255 255 255 255 255 255 255 255 255 255
 128 255 255 255 255 255 255 255 255 255 255 255 255 255 255 255
 128 255 255 255 178 138 138 138 248 255 255 255   0   0   0 255
 128 255 255 138   0   0   0   0   0 210 210 255   0   0   0 255
 128 255 255   0   0   0   0   0   0   0   0 228  32   0   0 255
 128 255 255   0   0   0   0   0   0   0   0 228  32   0   0 255
 128 251 251   0   0 251 251 255 102   0   0   0   0   0   0 255
 128 254 254   0  16 255 255 255 255  89  89   0   0   0   0 255
 128 255 255   0   0 234 234 255 255 255 255  32   0   0   0 255
 128 255 255   0   0 234 234 255 255 255 255  32   0   0   0 255
 128 255 255 127  32 149 149 255 255 255 255 248   0   0   0 255
 128 255 255 255 255 255 255 255 255 255 255 255 254 254 254 255
 128 255 255 255 255 255 255 255 255 255 255 255 255 255 255 255
 128 255 255 255 255 255 255 255 255 255 255 255 255 255 255 255
  64 128 128 128 128 128 128 128 128 128 128 128 128 128 128 128
 128 255 255 255 255 255 255 255 255 255 255 255 255 255 255 255
 128 255 255 255 255 255 255 255 255 255 255 255 255 255 255 255
 128 255 255 255 255 255 255 255 255 255 255 255 255 255 255 255
 128 255 255 255 178 138 138 138 248 255 255 255   0   0   0 255
 128 255 255 138   0   0   0   0   0 210 210 255   0   0   0 255
 128 255 255   0   0   0   0   0   0   0   0 228  32   0   0 255
 128 255 255   0   0   0   0   0   0   0   0 228  32   0   0 255
 128 251 251   0   0 251 251 255 102   0   0   0   0   0   0 255
 128 254 254   0  16 255 255 255 255  89  89   0   0   0   0 255
 128 255 255   0   0 234 234 255 255 255 255  32   0   0   0 255
 128 255 255   0   0 234 234 255 255 255 255  32   0   0   0 255
 128 255 255 127  32 149 149 255 255 255 255 248   0   0   0 255
 128 255 255 255 255 255 255 255 255 255 255 255 254 254 254 255
 128 255 255 255 255 255 255 255 255 255 255 255 255 255 255 255
 128 255 255 255 255 255 255 255 255 255 255 255 255 255 255 255
  64 128 128 128 128 128 128 128 128 128 128 128 128 128 128 128
 128 255 255 255 255 255 255 255 255 255 255 255 255 255 255 255
 128 255 255 255 255 255 255 255 255 255 255 255 255 255 255 255
 128 255 255 255 255 255 255 255 255 255 255 255 255 255 255 255
 128 255 255 255 178 138 138 138 248 255 255 255   0   0   0 255
 128 255 255 138   0   0   0   0   0 210 210 255   0   0   0 255
 128 255 255   0   0   0   0   0   0   0   0 228  32   0   0 255
 128 255 255   0   0   0   0   0   0   0   0 228  32   0   0 255
 128 251 251   0   0 251 251 255 102   0   0   0   0   0   0 255
 128 254 254   0  16 255 255 255 255  89  89   0   0   0   0 255
 128 255 255   0   0 234 234 255 255 255 255  32   0   0   0 255
 128 255 255   0   0 234 234 255 255 255 255  32   0   0   0 255
 128 255 255 127  32 149 149 255 255 255 255 248   0   0   0 255
 128 255 255 255 255 255 255 255 255 255 255 255 254 254 254 255
 128 255 255 255 255 255 255 255 255 255 255 255 255 255 255 255
 128 255 255 255 255 255 255 255 255 255 255 255 255 255 255 255
  64 128 128 128 128 128 128 128 128 128 128 128 128 128 128 128

 255 255 255 255 255 255 255 255 255 255 255 255 255 255 255 128
 255 255 255   0   0   0   0   0   0   0   0   0 254 255 255 128
 255 255 255   0   0   0   0   0   0   0   0   0 254 255 255 128
 255 255 255   0   0  32  32   0   0   0   0   0 254 255 255 128
 255 255 255 255 255 228 228   0   0  32  32 248 255 255 255 128
 255 255 255 255 210   0   0   0  89 255 255 255 255 255 255 128
 255 255 255 255 210   0   0   0  89 255 255 255 255 255 255 128
 255 255 255 248   0   0   0 102 255 255 255 255 255 255 255 128
 255 255 255 138   0   0   0 255 255 255 255 255 255 255 255 128
 255 255 255 138   0   0   0 251 255 234 234 149 255 255 255 128
 255 255 255 138   0   0   0 251 255 234 234 149 255 255 255 128
 255 255 255 178   0   0   0   0  16   0   0  32 255 255 255 128
 255 255 255 255 138   0   0   0   0   0   0 127 255 255 255 128
 255 255 255 255 255 255 255 251 254 255 255 255 255 255 255 128
 255 255 255 255 255 255 255 251 254 255 255 255 255 255 255 128
 128 128 128 128 128 128 128 128 128 128 128 128 128 128 128  64
 255 255 255 255 255 255 255 255 255 255 255 255 255 255 255 128
 255 255 255   0   0   0   0   0   0   0   0   0 254 255 255 128
 255 255 255   0   0   0   0   0   0   0   0   0 254 255 255 128
 255 255 255   0   0  32  32   0   0   0   0   0 254 255 255 128
 255 255 255 255 255 228 228   0   0  32  32 248 255 255 255 128
 255 255 255 255 210   0   0   0  89 255 255 255 255 255 255 128
 255 255 255 255 210   0   0   0  89 255 255 255 255 255 255 128
 255 255 255 248   0   0   0 102 255 255 255 255 255 255 255 128
 255 255 255 138   0   0   0 255 255 255 255 255 255 255 255 128
 255 255 255 138   0   0   0 251 255 234 234 149 255 255 255 128
 255 255 255 138   0   0   0 251 255 234 234 149 255 255 255 128
 255 255 255 178   0   0   0   0  16   0   0  32 255 255 255 128
 255 255 255 255 138   0   0   0   0   0   0 127 255 255 255 128
 255 255 255 255 255 255 255 251 254 255 255 255 255 255 255 128
 255 255 255 255 255 255 255 251 254 255 255 255 255 255 255 128
 128 128 128 128 128 128 128 128 128 128 128 128 128 128 128  64
 255 255 255 255 255 255 255 255 255 255 255 255 255 255 255 128
 255 255 255   0   0   0   0   0   0   0   0   0 254 255 255 128
 255 255 255   0   0   0   0   0   0   0   0   0 254 255 255 128
 255 255 255   0   0  32  32   0   0   0   0   0 254 255 255 128
 255 255 255 255 255 228 228   0   0  32  32 248 255 255 255 128
 255 255 255 255 210   0   0   0  89 255 255 255 255 255 255 128
 255 255 255 255 210   0   0   0  89 255 255 255 255 255 255 128
 255 255 255 248   0   0   0 102 255 255 255 255 255 255 255 128
 255 255 255 138   0   0   0 255 255 255 255 255 255 255 255 128
 255 255 255 138   0   0   0 251 255 234 234 149 255 255 255 128
 255 255 255 138   0   0   0 251 255 234 234 149 255 255 255 128
 255 255 255 178   0   0   0   0  16   0   0  32 255 255 255 128
 255 255 255 255 138   0   0   0   0   0   0 127 255 255 255 128
 255 255 255 255 255 255 255 251 254 255 255 255 255 255 255 128
 255 255 255 255 255 255 255 251 254 255 255 255 255 255 255 128
 128 128 128 128 128 128 128 128 128 128 128 128 128 128 128  64

 128 128 128 128 128 128 128 128 128 128 128 128 128 128 128  64
 255 255 255 255 255 255 255 255 255 255 255 255 255 255 255 128
 255 255 255 255 255 255 255 255 255 255 255 255 255 255 255 128
 255 254 254 254 255 255 255 255 255 255 255 255 255 255 255 128
 255   0   0   0 248 255 255 255 255 149 149  32 127 255 255 128
 255   0   0   0  32 255 255 255 255 234 234   0   0 255 255 128
 255   0   0   0  32 255 255 255 255 234 234   0   0 255 255 128
 255   0   0   0   0  89  89 255 255 255 255  16   0 254 254 128
 255   0   0   0   0   0   0 102 255 251 251   0   0 251 251 128
 255   0   0  32 228   0   0   0   0   0   0   0   0 255 255 128
 255   0   0  32 228   0   0   0   0   0   0   0   0 255 255 128
 255   0   0   0 255 210 210   0   0   0   0   0 138 255 255 128
 255   0   0   0 255 255 255 248 138 138 138 178 255 255 255 128
 255 255 255 255 255 255 255 255 255 255 255 255 255 255 255 128
 255 255 255 255 255 255 255 255 255 255 255 255 255 255 255 128
 255 255 255 255 255 255 255 255 255 255 255 255 255 255 255 128
 128 128 128 128 128 128 128 128 128 128 128 128 128 128 128  64
 255 255 255 255 255 255 255 255 255 255 255 255 255 255 255 128
 255 255 255 255 255 255 255 255 255 255 255 255 255 255 255 128
 255 254 254 254 255 255 255 255 255 255 255 255 255 255 255 128
 255   0   0   0 248 255 255 255 255 149 149  32 127 255 255 128
 255   0   0   0  32 255 255 255 255 234 234   0   0 255 255 128
 255   0   0   0  32 255 255 255 255 234 234   0   0 255 255 128
 255   0   0   0   0  89  89 255 255 255 255  16   0 254 254 128
 255   0   0   0   0   0   0 102 255 251 251   0   0 251 251 128
 255   0   0  32 228   0   0   0   0   0   0   0   0 255 255 128
 255   0   0  32 228   0   0   0   0   0   0   0   0 255 255 128
 255   0   0   0 255 210 210   0   0   0   0   0 138 255 255 128
 255   0   0   0 255 255 255 248 138 138 138 178 255 255 255 128
 255 255 255 255 255 255 255 255 255 255 255 255 255 255 255 128
 255 255 255 255 255 255 255 255 255 255 255 255 255 255 255 128
 255 255 255 255 255 255 255 255 255 255 255 255 255 255 255 128
 128 128 128 128 128 128 128 128 128 128 128 128 128 128 128  64
 255 255 255 255 255 255 255 255 255 255 255 255 255 255 255 128
 255 255 255 255 255 255 255 255 255 255 255 255 255 255 255 128
 255 254 254 254 255 255 255 255 255 255 255 255 255 255 255 128
 255   0   0   0 248 255 255 255 255 149 149  32 127 255 255 128
 255   0   0   0  32 255 255 255 255 234 234   0   0 255 255 128
 255   0   0   0  32 255 255 255 255 234 234   0   0 255 255 128
 255   0   0   0   0  89  89 255 255 255 255  16   0 254 254 128
 255   0   0   0   0   0   0 102 255 251 251   0   0 251 251 128
 255   0   0  32 228   0   0   0   0   0   0   0   0 255 255 128
 255   0   0  32 228   0   0   0   0   0   0   0   0 255 255 128
 255   0   0   0 255 210 210   0   0   0   0   0 138 255 255 128
 255   0   0   0 255 255 255 248 138 138 138 178 255 255 255 128
 255 255 255 255 255 255 255 255 255 255 255 255 255 255 255 128
 255 255 255 255 255 255 255 255 255 255 255 255 255 255 255 128
 255 255 255 255 255 255 255 255 255 255 255 255 255 255 255 128

